abbreviated - abbreviate
aerobicized - aerobicize
born - bear
bred - breed
brought - bring
called - call
elongated - elongate
freed - free
incised - incise
intermingled - intermingle
muted - mute
optimized - optimize
spelled - spell
intended - intend
unified - unify
distorted - distort
accessed - access
provided - provide
coined - coin
derived - derive
written - write
deployed - deploy
designed - design
represented - represent
exercised - exercise
maintained - maintain
inflected - inflect
simplified - simplify
categorized - categorize
executed - execute
reprogrammed - reprogram
related - relate
translated - translate
introduced - introduce
driven - drive
detailed - detail
needed - need
corrupted - corrupt
founded - found
removed - remove
decried - decry
detected - detect
simulated - simulate
considered - consider
found - find
hosted - host
dedicated - dedicate
extended - extend
offered - offer
journaled - journal
referred - refer
centered - center
printed - print
cancelled - cancel
canceled - cancel
allowed - allow
interpreted - interpret
applied - apply
described - describe
combined - combine
understood - understand
presented - present
stored - store
interrupted - interrupt
tied - tie
performed - perform
enabled - enable
specified - specify
said - say
advanced - advance
connected - connect
compiled - compile
declined - decline
heard - hear
wooded - wood
trademarked - trademark
began - begin
divided - divide
concerned - concern
retrieved - retrieve
utilized - utilize
opposed - oppose
adopted - adopt
exposed - expose
traced - trace
spoken - speak
associated - associate
implemented - implement
made - make
marketed - market
isolated - isolate
came - come
formulated - formulate
were - be
renewed - renew
compared - compare
changed - change
united - unite
given - give
formed - form
marked - mark
defined - define
updated - update
created - create
had - have
included - include
interested - interest
obtained - obtain
shortened - shorten
powered - power
placed - place
moved - move
originated - originate
pronounced - pronounce
required - require
based - base
rejected - reject
organized - organize
attacked - attack
used - use
winged - wing
branded - brand
recommended - recommend
ended - end
built - build
configured - configure
integrated - integrate
expected - expect
was - be
fixed - fix
assigned - assign
been - be
partitioned - partition
deemed - deem
regarded - regard
disconnected - disconnect
thought - think
oriented - orient
embedded - embed
ran - run
known - know
installed - install
