benches - bench
brushes - brush
cats - cat
cherries - cherry
crises - crisis
criteria - criterion
crossroads - crossroad
curriculums - curriculum
customs - custom
data - datum
dogmata - dogma
elves - elf
families - family
fathers - father
fathers-in-law - father-in-law
flowers - flower
forget-me-nots - forget-me-not
formulae - formula
formulas - formula
foxes - fox
grown-ups - grown-up
heroes - hero
kisses - kiss
leaves - leaf
lenses - lens
lilies - lily
millennia - millennium
millenniums - millennium
nots - not
octopi - octopus
passers - passer
passers-by - passer-by
phenomena - phenomenon
photos - photo
pianos - piano
plays - play
quizzes - quiz
referendums - referendum
returns - return
schemas - schema
schemata - schema
shoes - shoe
sights - sight
